src	tran	sentence
grupos	groups	La BLA -organización detrás del ataque contra la Bolsa de Valores de Karachi el 29 de junio- es solamente uno de los seis grupos separatistas armados de Baluchistán y que previamente han ejecutado ataques en Pakistán.
asesinato	murder	Christopher Tapp se encontraba cerca del río cuando supo del asesinato.
el	he	El Departamento de Policía de Idaho Falls seguía la teoría de que más de una persona estaba vinculada con el asesinato de Angie Dodge.
angie	Angie	Angie Dodge no había llegado a cumplir su turno en el trabajo y, después de que no contestara sus llamadas, se apresuraron a ver si estaba bien.
carol	Carol	Carol Dodge, la madre de la víctima, miró fijamente a Tapp todo el tiempo.  
provincia	Province	Pero ¿qué tiene esta provincia qué se ha convertido en un punto estratégico para China?
idaho	Idaho	El rio Snake, flanqueado por dos senderos prístinos, serpentea por el centro de la ciudad antes de continuar por la extensa llanura del sur de Idaho.
mundo	world	Fue allí, en bajo su extenso desierto, donde hace más de dos décadas Islamabad llevó a cabo los seis ensayos que convirtieron al país en el séptimo del mundo en desarrollar y probar con éxito las armas nucleares.  
dijo	said	"Yo dije: simplemente apártese y míreme hacerlo"", dijo."
china	China	Pero el proyecto no solo beneficia a China: Pakistán necesita desesperadamente esta inversión.  
pakistán	Pakistan	El corredor económico irá desde la Región Autónoma Uigur de Xinjiang, en el noroeste de China, al puerto de Gawadar en Baluchistán, en el suroeste de Pakistán, recorriendo así unos 3.000km.
puerto	port	"""Pakistán tiene solo un gran puerto, el puerto de Karachi, que fue construido durante el período colonial hace más de 100 años"", agrega."
baluchistán	baluchistan	Pakistán ha ejecutado proyectos gasíferos para explotar el gas de Baluchistán, por ejemplo.
proyectos	Projects	"""Otros grupos sienten que el gobierno federal que está dominado por Punjab -la provincia más poblada del país y la segunda más grande por superficie después de Baluchistán- no les permite a los baluchis tener una voz en los proyectos"".   "
policía	policeman	En el verano de 2017, el Departamento de Policía de Idaho Falls recibió un nuevo jefe, Bryce Johnson.
pero	but	"""Pero me di cuenta de que era sincera."
adn	dna	El método implica comparar la evidencia de ADN que se encuentra en la escena del crimen con el ADN de personas que entregan ADN a sitios web comerciales de genealogía como Ancestry.com.
después	after	Después, Hobbs y Sargis fueron liberados, pero Tapp, muy a su sorpresa y a pesar de que no había evidencia física vinculándolo a la escena del crimen, fue acusado de asesinato y violación.
caso	case	"""Habíamos hablado con el laboratorio estatal de Idaho y ellos entendían la importancia de este caso para la comunidad"", comentó Johnson."
grupo	group	Para Amy Mackinnon, investigadora del portal de análisis Foreign Policy con sede en Washington, el Grupo Wagner es difícil de definir y de anticipar las operaciones del grupo precisamente por esas características.
siria	Syria	Su marca también está perdiendo parte del brillo que pudo haber adquirido en las batallas contra el llamado Estado Islámico en Siria.
millones	millions	Se estima que la población en Italia sufrirá una caída similar: de 61 millones a 28 millones a lo largo de un período similar.  
población	population	Se espera que la población de Japón decaiga de su punto más alto en 2017, con 128 millones, a menos de 53 millones para fin de siglo.  
estudio	study	El estudio dice que Nigeria se transformará en el segundo país más poblado del mundo con una población de 791 millones.   
personas	persons	"""Eso sería cierto, excepto por la pirámide de edad invertida (más personas mayores que jóvenes) y todas las consecuencias negativas de una pirámide de edad invertida"", explica Murray.  "
mujeres	women	En cambio, este fenómeno está impulsado por el hecho de que más mujeres están accediendo a la educación, al trabajo, así como por el mayor acceso a métodos anticonceptivos, que hace que las mujeres puedan elegir tener menos niños.  
militar	military	"Los periodistas y analistas que le han seguido el rastro lo describen como una red de mercenarios alineados con los intereses del gobierno de Vladimir Putin a la que llegan a describir como una especie de fuerza militar ""no oficial"" a favor de Rusia."
seguridad	security	Los operadores de Wagner han estado también en Libia y han tenido un rol más tradicional de capacitación y de o seguridad en Sudán y la República Centroafricana.
países	countries	 Esta es la conclusión de un equipo de investigadores del Instituto de Métricas y Evaluaciones de Salud (IHME) de la Universidad de Washington, que publicó un estudio esta semana en la revista The Lancet,  La caída en los índices de fertilidad significa que casi todos los países podrían ver sus poblaciones reducidas para fines de siglo.  
niños	children	La tasa de fertilidad -el número promedio de niños que da a luz una mujer- está cayendo.    
intereses	interests	El alineamiento con la política de Putin Tanto Mackinnon como Stronski coinciden en que es visible el alineamiento entre el Grupo Wagner y los intereses del gobierno de Vladimir Putin.
mercenarios	mercenaries	"Ellos pueden contratar diferentes mercenarios y reclutar combatientes"", señala la experta a BBC Mundo.  "
número	number	La población también envejecerá de forma dramática, con casi el mismo número de personas que llegan a los 80 como de personas que nacen.  
libia	Libya	El desempeño de Wagner en Libia ha sido mucho menos exitoso, ya que Rusia finalmente tuvo que volver a desplegar parte de su poder aéreo desde Siria para reforzar su posición.
gobierno	government	De acuerdo al servicio ruso de la BBC, el Kremlin rechaza la existencia de esta organización y niega que el gobierno de Putin pueda tener cualquier vinculación con Wagner.
ruso	Russian	De acuerdo al servicio ruso de la BBC, el Kremlin rechaza la existencia de esta organización y niega que el gobierno de Putin pueda tener cualquier vinculación con Wagner.
rusia	Russia	"Los periodistas y analistas que le han seguido el rastro lo describen como una red de mercenarios alineados con los intereses del gobierno de Vladimir Putin a la que llegan a describir como una especie de fuerza militar ""no oficial"" a favor de Rusia."
fertilidad	fertility	Suiza logró incrementar su tasa de fertilidad de 1,7 a 1,9, pero otros países que han invertido un esfuerzo significativo para aumentarla no lo han logrado.
tasa	rate	Distintos países han recurrido a la inmigración para aumentar sus poblaciones y compensar la caída en la tasa de fecundidad.  
seca	dry	 Conocido como covid-19, se trata de una infección respiratoria que comienza con fiebre y tos seca y que, al cabo de cerca de una semana, puede provocar falta de aire.  
propagando	spreading	Actualiza tu navegador para el interactivo completo Actualmente, el virus se está propagando a mayor velocidad fuera del país donde se vieron los primeros casos.  
inma	imma	Investigación: Ana Pais- Guion: Inma Gil- Edición de video: Enric Botella- Presentadora: Ana María Roura -Editora: Natalia Pianzola.
casó	case	El personaje de Rivera tenía una relación y luego se casó con su mejor amiga Brittany, interpretada por Morris.  
actuación	performance	"Rivera y Riley realizaron la actuación musical número 300 de ""Glee"" en 2011."
fármaco	drug	"Sin embargo, Avifavir fue aprobado por el Ministerio de Salud de Rusia el 29 de mayo ""como el primer fármaco para el tratamiento del covid-19""."
reciente	recent	Una encuesta reciente, por ejemplo, encontró que el 65% de las mujeres dice lavarse las manos regularmente, por un 52% de los hombres.
ciudad	city	Por ejemplo, un estudio sobre el comportamiento de los usuarios del metro de Ciudad de México durante el brote de gripe porcina de 2009, que mató a casi 400 personas, encontró una mayor proporción de mujeres que de hombres con mascarillas.
nominados	nominees	"En la foto se puede ver a Rivera con sus compañeros actores de ""Glee"", Kevin McHale, Morris y Josh Sussman en la fiesta de nominados a los Premios Emmy de 2010."
oms	who	La investigación brasileña de Fiocruz Minas para la vacuna es una de las 160 catalogadas a principios de julio por la Organización Mundial de la Salud (OMS).
españa	Spain	Según ellos, hubo presencia del nuevo coronavirus en muestras congeladas, recolectadas en España, desde el 15 de enero de 2020 (41 días antes de la primera notificación oficial de un contagio en el país) y desde el 12 de marzo de 2019 (nueve meses antes del primer caso reportado en China).
heces	feces	El SARS-CoV-2 puede aparecer en las heces de hasta la mitad de los pacientes con covid-19, incluidos los que han tenido diarrea, un síntoma reportado por 1 de cada 5 pacientes.
estación	station	"A post shared by  Banksy (@banksy) on Jul 14, 2020 at 6:30am PDT Al final del video, las palabras ""I get lockdown"" (algo así como ""me confino"" en español) aparecen en el muro de una estación antes de que se cierren las puertas del tren para revelar las palabras ""but I get up again"" (pero me vuelvo a levantar)."
letra	lyrics	"Entonces comienza la canción Tubthumping de la banda inglesa Chumbawamba, cuya letra dice algo parecido a eso: ""I get knocked down, but I get up again"" (Me noquean pero me levanto de nuevo)."
biológico	biological	"""Tales comportamientos denotan que los acusados no acogieron genuinamente al niño en su familia, haciendo una clara distinción en el tratamiento con el niño biológico, incluso tomando la decisión drástica de devolverlo, sin tener en cuenta los sentimientos del niño y sin tener ninguna preocupación por la condición de un niño en desarrollo"", destacó el fallo de la jueza Marcia Dalla Déa Barone, del TJSP."
capa	cap	El calor de la capa actúa para estabilizar la atmósfera cuando el aire cálido de la nube de polvo se eleva por encima del aire relativamente más frío y denso.
adoptivos	adoptive	Por lo tanto, la jueza enfatizó que los padres adoptivos deben comprender las limitaciones y dificultades del niño.
incluimos	we include	El mapa que incluimos aquí —que se actualiza dos veces al día— te permitirá mantenerte informado de cuántos son los infectados y muertos por el virus y en qué países se encuentran.  
ampliar	enlarge	Al repartir ayuda en las zonas más golpeadas por la paralización de la economía en medio de la pandemia, buscan ampliar el apoyo de su base social y aumentar el control sobre la población a la que benefician, con el fin último de facilitar la continuación de su millonario negocio.
recién	newly	Se crearon albergues comunitarios para que los recién llegados guardaran 15 días de cuarentena antes de entrar a cualquier localidad.  
charla	chat	Ramakrishnan, quien es biólogo molecular, pone como ejemplo al empresario y filántropo Bill Gates, quien habló de la amenaza de una pandemia hace 5 años en una charla TED.
fiebre	fever	 Conocido como covid-19, se trata de una infección respiratoria que comienza con fiebre y tos seca y que, al cabo de cerca de una semana, puede provocar falta de aire.  
favorita	favorite	El mismo año, Rivera ganó dos galardones en los Premios Alma (American Latino Media Arts), como artista musical favorita y actriz de comedia de televisión favorita.
derecha	right	Rivera (tercera desde la derecha) apareció junto a otras estrellas, incluyendo (de izquierda a derecha) Lea Michele, Jenna Ushkowitz, Chris Colfer, Amber Riley, Heather Morris y Dianna Agron.
presencia	presence	"""Ninguna combinación de condiciones podría razonablemente asegurar la presencia de la acusada en la corte"", dijo la juez Nathan, que enumeró para su decisión las tres nacionalidades que tiene Maxwell, sus importantes recursos financieros y sus conexiones internacionales.   "
esqueleto	skeleton	Pero, hay una única excepción: el esqueleto de la Edad de Hierro.
acuerdo	agreement	Bajo creciente presión de parte de Carol Dodge, los abogados, y la comunidad de Idaho Falls, y ante la perspectiva de un largo proceso de apelación, el fiscal del condado Daniel Clark ofreció un acuerdo para liberar a Tapp.  
finanzas	finance	"""Esta pandemia es un tsunami a las finanzas personales"", le dice a BBC Mundo Bárbara Mainzer, académica de la Universidad Torcuato Di Tella, consultora y economista experta en finanzas y educación financiera."
emancipación	emancipation	Lo que he defendido es que debería haber un monumento adicional construido junto a ese, conmemorando ese día y también la historia de la Emancipación de forma creativa.
boleto	ticket	"Los demás son casos excepcionales: personas que venían y pensaban comprar un boleto después, entre otros casos diferentes"", prosigue.  "
uso	use	Tampoco hay ninguna recomendación oficial sobre el uso de lejía para contener el contagio a través de las aguas residuales, como ha estado circulando en los grupos de WhatsApp.
brote	outbreak	Por ejemplo, un estudio sobre el comportamiento de los usuarios del metro de Ciudad de México durante el brote de gripe porcina de 2009, que mató a casi 400 personas, encontró una mayor proporción de mujeres que de hombres con mascarillas.
vuelo	flight	Fanny, cuyo viaje de regreso, vía Colombia, estaba programado para el 20 de marzo, intentó adelantar su vuelo cuando escuchó que varios países estaban suspendiendo viajes y cerrando fronteras.  
giro	turn	Sin embargo, su destino dio un giro radical cuando consiguió una beca para estudiar en la Universidad de Toledo, en Ohio.
ebais	you were	A través de más de 1.000 clínicas del EBAIS, que cuentan con médicos, enfermeras, asistentes técnicos y farmacéuticos, se atienden los casos de covid-19 en la etapa de detección, la cual es crucial para contener los contagios.
minas	mines	 En 1936, Arturo Uslar Pietri tenía una inquietud y parecía angustiarle: “Esta gran proporción de riqueza de origen destructivo crecerá sin duda alguna el día en que los impuestos mineros se hagan más justos y remunerativos, hasta acercarse al sueño suicida de algunos ingenuos que ven como el ideal de la hacienda venezolana llegar a pagar la totalidad del Presupuesto con la sola renta de minas, lo que habría de traducir más simplemente así: llegar a hacer de Venezuela un país improductivo y ocioso, un inmenso parásito del petróleo, nadando en una abundancia momentánea y corruptora y abocado a una catástrofe inminente e inevitable”.
polvo	dust	"El riesgo sanitario para personas sensibles ""radica en el contenido de bacterias, virus, esporas, hierro, mercurio y pesticidas que presenta el polvo"", dice la OMS."
hazañas	feats	 Pero quizás te sorprenda saber que tiene seguidores capaces de hazañas numéricas asombrosas y que incluso existen competencias para ver quién sabe más decimales de Pi de memoria.  
aventuras	adventures	El videojuego Super Mario muestra las aventuras de un héroe fontanero que a menudo está acompañado por su hermano, Luigi.
lunes	Monday	En la conferencia de prensa de este lunes, las autoridades de Miami reconocieron que las demoras obedecían al alto número de pruebas y a la falta de capacidad en los laboratorios locales para procesar las muestras.
juego	game	"Uno de los más conocidos es el ""juego de la ballena azul"", que según varias organizaciones involucraba una serie de tareas -entre ellas, lesiones personales- que un usuario recibía a través de un administrador virtual y debía cumplir."
cara	face	"""La otra es con una pantalla facial, que te cubre toda la cara"", dice Ostrosky."
bolsas	bags	Dos bolsas de basura yacían frente a la estufa y, en la terraza exterior afuera de la cocina, un cenicero repleto y unos vasos de plástico evidenciaban que había habido una pequeña reunión el día anterior.
cordón	cord	Según De Luca, encontraron una elevada carga del virus en la placenta de la madre -que tiene un alto número de receptores similar a los pulmones- y establecieron que a través del cordón umbilical había contagiado al bebé.  
botella	bottle	Investigación: Ana Pais- Guion: Inma Gil- Edición de video: Enric Botella- Presentadora: Ana María Roura -Editora: Natalia Pianzola.
fenómeno	phenomenon	Sin embargo, el fenómeno puede presentarse en otras épocas del año.
concepto	concept	"De hecho, resulta incorrecto definir fenómenos tan dinámicos como la inmensa variabilidad humana y la historia de la evolución del hombre con un concepto estático y estéril como el de ""raza""."
rondas	rounds	Pero se les identifica porque suelen llevar un distintivo con el nombre de la ronda y una bincha (tira) de cuero de toro con la que reeducan a quienes se niegan a cumplir los usos y costumbres establecidos en la ley de rondas campesinas.  
violencia	violence	Fue el primer paso para abordar el tema de la violencia de género en su aldea, al lado del río Tapajós, en la Amazonía brasileña.
impuestos	taxes	"""La pandemia de covid-19 ha expuesto deficiencias en nuestros servicios públicos después de una década de recortes en términos reales, lo que significa que rara vez ha habido un momento más urgente u oportuno para pensar en grande sobre los impuestos"", le dijo a BBC Mundo."
videojuego	videogame	El videojuego Super Mario muestra las aventuras de un héroe fontanero que a menudo está acompañado por su hermano, Luigi.
preparados	prepared	"""Bill Gates hizo la analogía de que, aunque no queramos una guerra, estamos preparados con fuerzas militares incluso en tiempos de paz"", dice, comparándolo con contratar un seguro.  "
estados	state	Lo sucedido con la talidomida ayudó a que en 1962 se estableciera una legislación más robusta para regular los medicamentos en Estados Unidos.
bebé	baby	En el reporte se indica que el bebé al principio lució saludable, pero a los pocos días comenzó a verse irritado y con algunos movimientos corporales  inusuales.
tiempo	weather	"""Es una gran ventaja, no solo porque ganamos tiempo, sino que hay más intimidad cuando nos conectamos frente a la herramienta""."
jauría	pack	" Esta es la historia de ""La jauría"", la producción chileno-argentina que esta semana fue estrenada por la plataforma de video Amazon Prime para América Latina.  "
matemático	mathematical	En este video hablamos de un modelo matemático creado por la Universidad de Washington que aborda precisamente esa pregunta, y de sus proyecciones para los distintos países de la región de América Latina y el Caribe.  
investigación	investigation	Al analizar las encuestas del instituto de investigación YouGov, los científicos Daisuke Miyazawa y Gen Kaneko descubrieron que los países donde más personas dicen usar mascarillas tenían menos muertes por millón de personas.
transplacentaria	transplacental	Hasta el momento las investigaciones habían señalado que la infección transplacentaria era extremadamente rara.
romano	Roman	Se aprovechó de la grave crisis en la que se veía el nuevo emperador romano, Claudio II Gótico, quien al asumir en 268 debió hacer frente a la triple amenaza de los godos, los galos y la tribu germánica de los alamanes.  
hija	daughter	Tomando un paso increíble, Dodge dijo públicamente que creía que Tapp -que ya llevaba casi dos décadas en la cárcel por el asesinato de su hija- era inocente.
razas	races	Los resultados no mostraron diferencias significativas desde el punto de vista molecular para separar razas humanas.
florida	Florida	Encontró una compañía en Florida que podía identificar la raza por la muestra de ADN y la policía acordó hacer la prueba.
cruzado	crossed	"Tenemos que prever y anticiparnos en fortalecer la atención primaria, porque la realidad es que vamos a tener que aprender a convivir con el coronavirus"", sentencia Cruzado."
norte	north	El Instituto Nacional de Meteorología e Hidrología (Inameh) advirtió que esta situación se mantendrá en los próximos días, sobre todo en la zona norte.
amazonía	amazon	Fue el primer paso para abordar el tema de la violencia de género en su aldea, al lado del río Tapajós, en la Amazonía brasileña.
plástico	plastic	Dos bolsas de basura yacían frente a la estufa y, en la terraza exterior afuera de la cocina, un cenicero repleto y unos vasos de plástico evidenciaban que había habido una pequeña reunión el día anterior.
pandemia	pandemic	"""Quizás nos interese estar preparados: reservar capacidad en los hospitales, tener un personal de reserva, que trabaje en otros puestos pero que esté formado para poder recurrir a ellos en caso de pandemia, etc.""."
contactos	contacts	El caso de Raúl y sus familiares es solo uno de los tantos miles que ha reportado el estado en las últimas semanas en Miami donde el creciente número de positivos, la demora en los resultados de los test, el aumento en las hospitalizaciones y el escaso rastreo de contactos han contribuido a convertirlo en el nuevo epicentro del covid-19 en Florida y en EE.UU. Los números han ido multiplicándose por día y solo el pasado domingo, el estado reportó casi 15.300 nuevos contagios, la tercera parte de los cuales se registraron en Miami-Dade.
julio	July	La juez rechazó la petición de libertad condicional que hizo la defensa y fijó la fecha de comienzo del juicio para el 12 de julio de 2021.
análisis	analysis	La recuperaron e inmediatamente la enviaron para análisis.
genéticamente	genetically	"La demanda se concentra en una sola institución porque el laboratorio es posiblemente el único que produce estos ratones genéticamente modificados a escala ""comercial"", dice el coordinador del Instituto Nacional de Ciencia y Tecnología de Vacunas de Brasil (INCTV) y del equipo de Fiocruz Minas, Ricardo Gazzinelli."
venezolano	Venezuelan	“Me formé en instituciones del Estado venezolano, toda mi vida profesional la he dedicado al desarrollo de mi país.
reencontrarnos	meet again	Este ha sido tiempo de reencontrarnos con nosotros mismos y quisiera que pronto sea tiempo de reencontrarnos todos en un gran concierto en el que celebremos la vida….
valoradas	valued	"""Los 'antiguos' juegos empaquetados (y sin uso) que están asociados a marcas y compañías de videojuegos muy valoradas, especialmente si son versiones raras, han aumentado enormemente su precio en los últimos 20 años"", describió Piers Harding-Rolls, experto en videojuegos de la compañía de investigación Amper Analysis."
guion	script	Investigación: Ana Pais- Guion: Inma Gil- Edición de video: Enric Botella- Presentadora: Ana María Roura -Editora: Natalia Pianzola.
agradece	thanks	"En su comunicado, TFL dice que agradece el mensaje ""animando a los usuarios a llevar mascarillas""."
perfumistas	perfumers	"La asociación entre IA y perfumistas está anclada en esta filosofía"", asegura."
chris	Chris	"""Sin encontrar al asesino de mi hija y la persona con el ADN correspondiente"", destacó, ""¿podríamos probar que Chris no estuvo allí?""."
puede	may	Además del uso de drogas, este tipo de análisis de partículas halladas en alcantarillas puede usarse para analizar hábitos relacionados con el consumo de alimentos y medicinas.
carnicería	Butcher shop	Marta, de 36 años, tiene 5 hijos y es el único sustento de su familia, lleva cinco años trabajando en la Carnicería “El Ahorro”.
modo	mode	De igual modo, es inevitable que haya brotes de casos hasta que se alcance un umbral suficiente de protección en la población, esto es, la inmunidad de rebaño.
cálculo	calculation	"Claro que hacer este cálculo es ""en parte ciencia y en parte arte"", como señala la propia organización."
nacido	born	"Siempre ha sido una amenaza"", dice el investigador nacido en India."
vulnerables	vulnerable	"En una de esas entregas, el pasado junio, Akalapeizime Castro, jefe del ente público Mercal, encargado de luchar contra la inseguridad alimentaria, dijo que ""en está cuarentena colectiva, el gobierno nacional asegura la alimentación a las poblaciones más vulnerables""."
justicia	Justice	Entre ellos estaba Michael Heavey, un juez jubilado que fundó Jueces para la Justicia, que trabaja en anular condenas erradas.
dicen	they say	"Esto, dicen, es un problema que no se puede resolver con la caridad, por generosa que sea"", cuenta Theo Leggett, corresponsal de Negocios de la BBC.  "
vacuna	vaccine	Los ratones genéticamente modificados se usarán en los llamados estudios de desafío para verificar la efectividad: después de aplicar la vacuna, se intenta infectarlos con el virus.  
petrolera	oil	Si bien el presidente de la Fundación Casa Arturo Uslar Pietri reconoce que se hicieron grandes obras de infraestructura gracias a la renta petrolera, hubo un efecto colateral: “Lamentablemente
juez	judge	"El estadounidense había defendido que el juez en su juicio en Arkansas ""pasó por alto pruebas de ADN"" que supuestamente probaban que estaba en otro punto del país en el momento de los asesinatos, recoge el diario The New York Times."
india	India	"Siempre ha sido una amenaza"", dice el investigador nacido en India."
pintando	painting	En las imágenes se como le pide a un pasajeros de la Central Line que se aparte mientras se pone a trabajar, pintando imágenes de ratas con mascarillas en el vagón.
industria	industry	Buttó lo interpreta como una preocupación basada en la dinámica del negocio petrolero de esa época: “Yo creo que Uslar Pietri se refería a que la industria petrolera venezolana estaba en manos de compañías extranjeras y la única fuente de ingreso que Venezuela obtenía del negocio petrolero estaba basado en el cobro de regalías (…) Y los impuestos sobre la renta que generaba la venta de ese petróleo”.
imágenes	images	Estudios han demostrado que las imágenes de gente atractiva desnuda pueden llamarnos la atención, incluso cuando no somos totalmente conscientes de ello.  
afirma	it states	"""Si estás buscando enseñarle a su hijo [pequeño] cómo manejar el dinero, estas tarjetas le ayudarán"", afirma Saxon."
menudo	often	La avalancha de pacientes desbordó los hospitales y la atención fue a menudo subóptima.
amenaza	threat	Ramakrishnan, quien es biólogo molecular, pone como ejemplo al empresario y filántropo Bill Gates, quien habló de la amenaza de una pandemia hace 5 años en una charla TED.
sanciones	penalties	"""Las sanciones no afectan ni en lo físico ni en lo psicológico."
mitad	half	Más de la mitad de las personas que habitan el planeta, cerca de 3.900 millones, viven en solo siete países.  
mantenerte	keep you	El mapa que incluimos aquí —que se actualiza dos veces al día— te permitirá mantenerte informado de cuántos son los infectados y muertos por el virus y en qué países se encuentran.  
brasil	Brazil	La cronología de la pandemia en Brasil también puede cambiar.
resultados	results	Ante esta situación, Trepka recomienda que, como medida de precaución, cualquier persona que presente síntomas se aísle mientras espera los resultados.
prestado	borrowed	Pese a todas las precauciones que puedas tomar cuando te piden dinero prestado, no deja de ser un terreno pantanoso que tiene un doble riesgo: perder tus fondos y perder un amigo.
dinero	money	"Están convencidos de que vivir disfrutando de grandes sumas de dinero y la seguridad que esto aporta sin contribuir a la sociedad ""está mal""."
reconstruir	rebuild	"""Hemos encontrado una manera distinta de reconstruir las ciudades estadounidenses utilizando tecnología"", dice la fundadora de Bitwise."
actualiza	update	El mapa que incluimos aquí —que se actualiza dos veces al día— te permitirá mantenerte informado de cuántos son los infectados y muertos por el virus y en qué países se encuentran.  
luz	light	Vero es parte de un proyecto de atención médica que apoya a las mujeres durante el embarazo y después de dar a luz.
presentadora	presenter	Investigación: Ana Pais- Guion: Inma Gil- Edición de video: Enric Botella- Presentadora: Ana María Roura -Editora: Natalia Pianzola.
sistema	system	El sólido sistema de salud de Costa Rica ha sido clave para combatir la pandemia de coronavirus en el país, en especial las unidades de Equipos Básicos de Atención Integral de la Salud (EBAIS).
raza	race	"Se consideraban ellos mismos la raza ""cumbre""."
animales	animals	Merrell, como sucedía con otras farmacéuticas de la época, no había probado el fármaco en animales preñados,.
informado	informed	El mapa que incluimos aquí —que se actualiza dos veces al día— te permitirá mantenerte informado de cuántos son los infectados y muertos por el virus y en qué países se encuentran.  
departamento	Department	La mano dura de los ronderos durante la pandemia responde también a las carencias de la región en cuanto a atención hospitalaria, que atemorizan a los habitantes del departamento de Cajamarca.  
sueños	dreams	"En 2016, Rivera publicó un libro titulado ""Sorry Not Sorry: Dreams, Mistakes, and Growing Up"" (Lo siento pero no lo siento: sueños, errores y crecimiento), que insta a las mujeres jóvenes a perseguir sus sueños y a negarse a dejar que los errores las definan."
aguas	waters	Tampoco hay ninguna recomendación oficial sobre el uso de lejía para contener el contagio a través de las aguas residuales, como ha estado circulando en los grupos de WhatsApp.
propiedad	property	Maxwell, de 58 años, se comprometía a entregar sus pasaportes de EE.UU., Reino Unido y Francia y a recluirse en una propiedad de Nueva York con un dispositivo de monitoreo electrónico por GPS.
institución	institution	La institución sin fines de lucro fue creada en 1929 y es una referencia en genética a nivel mundial.  
tribunal	court	La indemnización fue impuesta en un fallo de primera instancia y luego fue confirmada por el Tribunal de Justicia de Sao Paulo.  
redes	nets	La preocupación es que los piratas informáticos patrocinados por el agentes estatales podrían usar estos dispositivos, que a menudo tienen características de seguridad más débiles, como puertas traseras en redes estratégicamente vitales.  
comunicaciones	communications	En teoría, controlar la tecnología en el corazón de estas redes podría darle a Huawei la capacidad de espiar o interrumpir las comunicaciones durante cualquier disputa futura.  
kilómetros	kilometres	Y aunque está ubicado a dos horas y media de Silicon Valley, bien podría estar a miles de kilómetros de distancia.
alimentaria	food	"Esto, en una región en la que, según el reporte ""Estado de la seguridad alimentaria y la nutrición en el mundo 2020"" publicado por la FAO este lunes, una dieta capaz de cubrir las necesidades energéticas mínimas cuesta US$1,6 diarios por persona."
comedia	comedy	El mismo año, Rivera ganó dos galardones en los Premios Alma (American Latino Media Arts), como artista musical favorita y actriz de comedia de televisión favorita.
andamos	we walk	"""Andamos y andamos por kilómetros y la misma imagen se repetía y se repetía""."
transporte	transport	De hecho, en el transporte público londinense es obligatorio.
humanas	human	Los acuerdos de palabra -de todo tipo- suelen ser una fuente de conflictos por la propia complejidad de las relaciones humanas y la manera en que nos comunicamos.
tecnología	technology	Entonces, ¿la introducción de la tecnología significa el final del perfumista?
vertedero	dump	Es difícil estimar cuán grande es este vertedero de basura, porque es informal.
ratón	mouse	De ahí la idea de desarrollar un ratón que pueda usarse en la investigación para comprender mejor la enfermedad.
máscaras	More expensive	También hay diferencias de género incluso en los países asiáticos donde usar máscaras faciales es una norma social ampliamente establecida y ampliamente observada.
venezolana	Venezuelan	lo que se hizo con la industria petrolera fue hacer crecer al Estado de manera abusiva, de manera inmensa, y eso provocó que la sociedad venezolana entera dependiera de él y no al revés”.
nivel	level	Bajo el sistema judicial estadounidense, los delitos pueden ser juzgados en cortes federales (a nivel nacional) o cortes de cada estado, a nivel regional.
mónica	Monica	Después de darle un ultimátum a su esposo, Mónica vio un cambio radical que se tradujo en un final feliz: Eduardo lleva una mascarilla desde hace un tiempo.
ayudó	helped	Kelsey ayudó a Geiling a investigar la muerte de 107 personas en diferentes partes del país.
escondida	hidden	La fiscalía del distrito sur de Nueva York ofreció el lunes detalles del arresto de Maxwell, que se produjo el 2 de julio en Bradford, Nuevo Hampshire, donde las autoridades aseguran que estaba escondida en una propiedad de 63 hectáreas que compró en diciembre en una transacción en efectivo con la identidad protegida.
humano	human	Y la respuesta no era otra que en el capital humano.
serie	Serie	La serie, entre los varios temas que toca, incluye el de los populares, y a veces peligrosos, desafíos que se lanzan por redes sociales.  
basura	garbage	Pero los vertederos de basura rodean Maicao, una ciudad fronteriza impactada por el contrabando y el comercio informal, y se esparcen por kilómetros a la redonda.
venezolanos	Venezuelans	“Y sería negar la condición de millones de venezolanos que hemos puesto nuestro empeño, nuestro trabajo, en función del desarrollo nacional”.
visión	vision	En mi investigación, me interesa la forma en que la visión ciega revela las fronteras difusas en los límites de la visión y la conciencia.  
medicamento	medicine	 Se trata de un antiviral desarrollado a partir del favipiravir, un medicamento japonés usado contra la influenza, aunque algunos expertos sostienen que no hay pruebas concluyentes sobre su efectividad para combatir la covid-19.
calidad	quality	"Sin embargo, citó que ""no se puede admitir que los adoptantes se comporten de manera intrascendente en su decisión de adoptar y recibir al menor en su familia dentro de la calidad de un niño"".  "
pago	payment	Entonces, ¿cómo prestarle dinero a ese familiar o amigo sin arriesgarte a una pelea, dado que la probabilidad de no pago es bastante alta en este contexto de incertidumbre económica?
aprobado	approved	El Avifavir no es el único medicamento aprobado por las autoridades rusas para combatir la covid-19.  
medicamentos	medicines	En los inferiores, se encontró un uso significativo de medicamentos por prescripción.
abajo	down	Los restos de este hombre de la Edad del Hierro fueron encontrados en posición boca abajo en Wellwick Farm, cerca de Wendower, condado de Buckinghamshire, en el sureste de Inglaterra.
adopción	adoption	Más tarde, el abogado de la pareja, Ivelson Salotto, se puso en contacto con BBC Brasil y negó que el niño sufrió daños después de que la familia cancelara la adopción.
ciega	blind	¿Cómo funciona entonces la visión ciega?
aire	air	Los restaurantes pueden operar solo en espacios al aire libre, mientras los que vayan a los gimnasios deben usar mascarillas.
embalaje	packaging	El cartucho del juego, aún en su embalaje original, se vendió a un postor anónimo.
dice	He says	Antonio Ecarri, presidente de la Fundación Casa Arturo Uslar Pietri, tiene una opinión similar y añade: “Más que una profecía, ‘Sembrar el petróleo’ se convirtió en la gran tarea inconclusa de los venezolanos”, le dice a BBC Mundo.
egipto	Egypt	Con Roma ocupada, Zenobia invadió Egipto en 269 y se proclamó reina.
rivera	riverbank	"Rivera, tercera desde la derecha, junto a sus coprotagonistas en los Globos de Oro en 2011, donde ""Glee"" ganó como mejor serie de comedia o musical por segundo año consecutivo.  "
marzo	March	Al aumentar los contagios, las autoridades pusieron el país en confinamiento obligatorio el 25 de marzo y esta semana el presidente Iván Duque anunció que seguirá hasta el 31 de mayo.
sitio	site	En el sitio también hay evidencias de ocupación doméstica durante la Edad de Bronce a Hierro (del año 3000 a. C. al 43 d. C.), incluyendo un taller de máquinas.
roma	Rome	Con Roma ocupada, Zenobia invadió Egipto en 269 y se proclamó reina.
hierro	iron	"El riesgo sanitario para personas sensibles ""radica en el contenido de bacterias, virus, esporas, hierro, mercurio y pesticidas que presenta el polvo"", dice la OMS."
imaginaelmundo	imagine the world	Así lo afirma el premio Nobel de Química 2009 Venki Ramakrishnan, en la que fue la décima y última charla del ciclo de entrevistas virtuales #ImaginaElMundo de Hay Festival y BBC Mundo.
muerte	death	 Con su negativa ayudó a “salvar, quizás, a miles de personas de la muerte o de una incapacidad de por vida”, dice la Administración de Alimentos y Medicamentos (FDA, por sus siglas en inglés).
coleccionistas	collectors	"""Esto se debe a que estos artículos ahora están firmemente arraigados en la nostalgia de los juegos infantiles para muchos coleccionistas de entre 30 y 40 años"", explicó."
premios	awards	Ganó varios premios literarios, entre ellos, el Príncipe de Asturias de Las Letras y el Rómulo Gallegos.
méxico	Mexico	La Administración Nacional Oceánica y Atmosférica de EE.UU. (NOAA) pronosticó hace unos días que la columna se movería en dirección oeste a través del mar Caribe, pasando por áreas del norte de Sudamérica, Centroamérica y las costas estadounidenses en el Golfo de México.
celeste	light blue	"Uno de los casos en los que se pudo haber inspirado fue el de 'La manada', pero también en los miles de casos de violencia contra las mujeres que ocurren a diario alrededor del mundo"", le dijo a BBC Mundo Paula Luchsinger, quien interpreta a Celeste Ibarra."
partículas	particles	"""En ese caso, el potencial de que el paciente expulse partículas de virus es grande y es importante proteger los ojos del trabajador sanitario con gafas o con una pantalla facial, por encima de la mascarilla"".  "
hospitales	hospitals	Sin esperar el apoyo gobierno central, buscaron garantizar algunos recursos para dotar mejor a sus dos hospitales y aplicaron un cerco epidemiológico en sus cincos principales accesos.
desde	since	Desde entonces y hasta este 14 de julio, se habían registrado 243 casos, todos ellos importados.  
talidomida	thalidomide	En febrero de 1961 -cuenta Phillips- la médica leyó un artículo en la revista British Medical Journal, en el que un doctor reportaba efectos adversos en los brazos y piernas de pacientes que había tratado con talidomida.
espiar	to spy	Estados Unidos dice que Huawei podría ser utilizado por China para espiar, a través de su tecnología 5G.  Señala los antecedentes militares de Ren y el papel de Huawei en las redes de comunicaciones para argumentar que representa un riesgo de seguridad.
joaquín	Joaquin	"Un equipo de la BBC obtuvo acceso exclusivo a las bodegas desde las cuales organiza sus donaciones el cartel de Sinaloa, la organización liderada por Joaquín ""El Chapo"" Guzmán, preso en Estados Unidos desde enero de 2016.  "
país	country	Desde el pasado agosto al 13 de enero de este año, se cancelaron 73 adopciones en el país, según el Sistema Nacional de Adopción y Recepción (SNA) del CNJ.  
estaba	I was	"Estaba furiosa con él"", recordó."
logró	achievement	Con gran astucia militar, logró no solo mantener a raya a los persas sino también conquistar terrenos que pertenecían al Imperio romano.
cortes	cuts	Bajo el sistema judicial estadounidense, los delitos pueden ser juzgados en cortes federales (a nivel nacional) o cortes de cada estado, a nivel regional.
sólo	alone	Un ejemplo fue la masificación de la educación, no sólo primaria y secundaria sino universitaria.
crimen	crime	El método implica comparar la evidencia de ADN que se encuentra en la escena del crimen con el ADN de personas que entregan ADN a sitios web comerciales de genealogía como Ancestry.com.
reclutar	recruit	"La acusación dice que Maxwell ""asistió, facilitó y contribuyó al abuso de Epstein a niñas menores de edad al ayudarlo a reclutar y finalmente abusar de víctimas que tanto Maxwell como Epstein sabían que eran menores de 18 años""."
california	California	De las 10 zonas más pobres de California, cuatro están en Fresno, un condado mayoritariamente hispano con un millón de habitantes, de los cuales más del 20% vive bajo la línea de pobreza.
confederados	Confederate	Después hubo muchos intentos de cuestionar o eliminar monumentos confederados en todo el país.
monumento	monument	Usted ha escrito sobre el monumento a la Emancipación en Washington (que representa al expresidente Lincoln parado y a un hombre negro arrodillado con las cadenas rotas), concordando en que es una imagen racista, pero argumentó en contra de su remoción.
música	music	Edinson (@edinsonmusic_): “Desde hace mucho tiempo he tenido las ganas de transformar al mundo aportando mi granito de arena desde la música.
nube	cloud	Puerto Rico también vio el paso de la nube de polvo.
alimentación	feeding	"En una de esas entregas, el pasado junio, Akalapeizime Castro, jefe del ente público Mercal, encargado de luchar contra la inseguridad alimentaria, dijo que ""en está cuarentena colectiva, el gobierno nacional asegura la alimentación a las poblaciones más vulnerables""."
aquí	here	 Si no puedes ver el video haz clic aquí.
cartel	poster	Según expertos en seguridad, esta estrategia de los carteles no es exclusiva del cartel de Sinaloa ni de México.
dieta	diet	"Y, según la organización humanitaria, ya hay evidencia de que un número cada vez mayor de venezolanos ""está reduciendo la cantidad y calidad de la comida de su dieta""."
conciencia	awareness	"Otros individuos con visión ciega dicen sentir ""pinchazos visuales"" o ""sombras oscuras"", lo que apunta a la posibilidad tentadora de que les quedó algo de conciencia."
pregunta	question	"""Un buen fundador tiene el mejor interés de la compañía en su corazón y constantemente se pregunta qué necesita la compañía."
quiero	I want	Orlandito (@catire84): “Quiero ver a mi novia.
seguidores	followers	El programa pronto ganó una gran cantidad de seguidores.  
oficial	official	Tampoco hay ninguna recomendación oficial sobre el uso de lejía para contener el contagio a través de las aguas residuales, como ha estado circulando en los grupos de WhatsApp.
información	information	Cuando esto no tuvo mucho resultado, se puso a patrullar las calles hasta entrada la madrugada y preguntando a quien estuviera dispuesto a escuchar sí tenían información sobre la muerte de su hija.
computación	computing	Tras seguir un programa de estudios de cinco años y medio, se graduó en Ciencias de la Computación e Ingeniería en Computación.
odenato	ordinate	En agradecimiento por defender la frontera oriental del Imperio romano, Odenato fue nombrado rey de Palmira en 260.
entierro	burial	"Según Wood, lo fascinante del sitio es su ""uso persistente durante siglos para el entierro de personas específicas de alto estatus""."
exclusiva	exclusive	Según expertos en seguridad, esta estrategia de los carteles no es exclusiva del cartel de Sinaloa ni de México.
colón	colon	Pero culpar a Cristóbal Colón por la explotación de las Américas por parte de los europeos es un poco ridículo.
pantalla	screen	"""Por eso hay un consenso creciente entre epidemiólogos de que la pantalla puede ser una muy buena alternativa para protegerse dentro un contexto comunitario"".  "
pareja	couple	La defensa de la pareja presentó una apelación ante el TJSP solicitando una reducción en la indeminzación, alegando que no se corresponde con la realidad financiera de la familia.  
podemos	we can	Hay algunos monumentos que habré defendido, como el Memorial de Freedmen, una estatua de Lincoln de pie y un esclavo arrodillado en Washington D.C. Pero no podemos purificar el pasado.
césar	cease	Sin embargo, la justicia señaló que dichos informes eran innecesarios, ya que hay innumerables pruebas en los registros que muestran el daño sufrido por César después de ser abandonado por la familia.
enero	January	Pero los análisis realizados por investigadores de la Fundación Oswaldo Cruz (Fiocruz) revelan que en Brasil hubo al menos un caso de SARS-Cov-2 un mes antes, entre el 19 y el 25 de enero.
solicitud	request	En una entrevista con la Universidad de Victoria, de Canadá, Kelsey recordó esa etapa de su vida profesional: “Mi primera aplicación fue para el fármaco talidomida y me la dieron porque, como era nueva, pensaron que debía tener una (solicitud) fácil para empezar”, dijo.
videojuegos	video game	"""Los 'antiguos' juegos empaquetados (y sin uso) que están asociados a marcas y compañías de videojuegos muy valoradas, especialmente si son versiones raras, han aumentado enormemente su precio en los últimos 20 años"", describió Piers Harding-Rolls, experto en videojuegos de la compañía de investigación Amper Analysis."
sorprenda	surprise	 Pero quizás te sorprenda saber que tiene seguidores capaces de hazañas numéricas asombrosas y que incluso existen competencias para ver quién sabe más decimales de Pi de memoria.  
entonces	so	Pero ¿cómo, entonces, se pueden solventar estas lagunas?
ensayos	essays	Según las autoridades sanitarias de ese país, los ensayos clínicos, así como los datos del primer mes de uso hospitalario, demostraron resultados positivos cuando se usa el fármaco en las etapas inicial y media de la enfermedad.
interactivo	interactive	Actualiza tu navegador para el interactivo completo Actualmente, el virus se está propagando a mayor velocidad fuera del país donde se vieron los primeros casos.  
hizo	did	Mondolfi Gudat señala: “No comparto esa visión de la maldición del petróleo (…) porque creo que si algo hizo el petróleo fue darle un sentido absolutamente inesperado a lo que iba a significar la dinámica venezolana y al mejoramiento no sólo de las condiciones materiales de la sociedad, sino del advenimiento de agentes de poder distintos a los núcleos gobernantes”.
oriente	East	Pero el propio Odenato había dejado en claro que su ambición iba más allá: el objetivo último era dominar el Oriente.
intentaba	was trying	En Medellín, Colombia, todavía existe un barrio construido por Pablo Escobar en la época en que intentaba convertirse en una figura política.
brotes	sprouts	"""Estos brotes deben investigarse adecuadamente con personas en el terreno, una por una."
combinaciones	combinations	"Lo bueno es que la máquina ofrece una selección de aromas y combinaciones interesantes en las que no habrías pensado""."
papel	paper	Estados Unidos dice que Huawei podría ser utilizado por China para espiar, a través de su tecnología 5G.  Señala los antecedentes militares de Ren y el papel de Huawei en las redes de comunicaciones para argumentar que representa un riesgo de seguridad.
producido	produced	El 75% del plástico producido hasta hoy en el mundo es basura.
quisiera	I would like	Este ha sido tiempo de reencontrarnos con nosotros mismos y quisiera que pronto sea tiempo de reencontrarnos todos en un gran concierto en el que celebremos la vida….
teléfonos	phones	La decisión de Reino Unido no afecta la capacidad de Huawei para vender sus teléfonos inteligentes a los consumidores.
comercializado	marketed	El medicamento nunca fue comercializado en Estados Unidos.
mascarillas	face masks	Pero la encuesta nacional más reciente, hecha en junio, mostró que mientras el 68% de las mujeres que apoyan a los republicanos utiliza mascarillas fuera del hogar de forma frecuente, solamente un 49% de los hombres dijo ponerse una al salir de casa.
menores	minors	Estos casos involucran a menores que vivían con la familia, cuando un niño aún está en la etapa de cuidado, pero el proceso de adopción aún no se ha completado.
protección	protection	Hay que subrayar que las personas seropositivas, tuvieran o no síntomas tras la infección aguda, desarrollan inmunidad (protección) frente al coronavirus durante 1-2 años, tiempo suficiente para que podamos disponer de una vacuna.
asesino	assassin	Dodge solía meterse en la comisaría local de policía sin que fuera anunciada para exigir saber lo que el departamento estaba haciendo para dar con el asesino de Angie.
ancianos	seniors	La primera, reforzar los sistemas sanitarios, con especial atención a los servicios de atención médica a los ancianos en domicilios y geriátricos.
confinamiento	lockdown	El confinamiento universal fue una medida desesperada.
la	the	La situación, como destacó el rector de la UACB, el padre Francisco José Virtuoso, es desesperada.
contribuir	contribute	Hasta 83 ultrarricos de distintos países han firmado una carta en la que piden a sus gobiernos que les suban los impuestos para contribuir en la factura de los nuevos programas gubernamentales destinados a reactivar la economía tras la pandemia de covid-19.
residencias	residences	Sin embargo, esto excluye las residencias geriátricas, además de que esta cifra asciende al 20-25% en grandes ciudades como Madrid.  
encovi	shrunk	La misma ENCOVI estima que nueve de cada 10 hogares venezolanos (un 96%) presenta pobreza de ingreso, mientras que la pobreza multidimensional -relacionada con indicadores como educación, estándar de vida, empleo, servicios públicos y vivienda- ya afecta a 64,8% de los hogares, un aumento del 13,8% entre 2018 y 2019.
sangre	blood	"Se necesita la sangre materna, la sangre del recién nacido, la sangre del cordón umbilical, la placenta, el líquido amniótico... y es extremadamente difícil obtener todas estas muestras en una pandemia con emergencias por todas partes"", agrega.  "
faciales	facial	En el documento que sirve de guía para el uso de las mascarillas en el contexto de la covid-19, con fecha del 5 de junio, señala que las pantallas faciales pueden ser más fáciles de usar para personas con desórdenes de salud mental, problemas de desarrollo, sordera o dificultades auditivas y niños.  
semanas	weeks	El relajamiento de las medidas de aislamiento social ya se deja sentir en Cajamarca, que ahora reporta un rango de transmisión de 1,16%, cuando hace dos semanas era menos de 1%.
onu	un	Además, la ONU proyecta que India superará a China como el país más poblado del mundo alrededor de 2027, mientras la población del África Subsahariana se duplicará para 2050.
pena	pain	La pena capital fue ilegalizada a nivel federal y regional por un fallo de la Corte Suprema de 1972.
numéricas	numerical	 Pero quizás te sorprenda saber que tiene seguidores capaces de hazañas numéricas asombrosas y que incluso existen competencias para ver quién sabe más decimales de Pi de memoria.  
eeuu	USA	Decenas de casos positivos de covid-19 entre migrantes guatemaltecos deportados desde EE.UU. encendieron las alarmas de las autoridades del país centroamericano.
exclusivo	exclusive	"Un equipo de la BBC obtuvo acceso exclusivo a las bodegas desde las cuales organiza sus donaciones el cartel de Sinaloa, la organización liderada por Joaquín ""El Chapo"" Guzmán, preso en Estados Unidos desde enero de 2016.  "
clínicos	clinical	"La característica del SARS-CoV-2 de generar casos de alta gravedad y con una letalidad relativamente alta en la población hace que sea poco probable que este virus circule en una región sin evidencia de casos clínicos""."
viernes	Friday	Marvelis (@paredesmarvelis): “Quiero regresar a mis viernes de formación con @alimentalasolidaridad, porque son mi espacio de desarrollo personal y profesional... y ni hablar de la falta que me hacen mis compañeras”.
clientes	customers	"Pero ha generado un gran revuelo entre los clientes interesados en cómo pueden ver creaciones con él""."
paralización	paralyzation	Al repartir ayuda en las zonas más golpeadas por la paralización de la economía en medio de la pandemia, buscan ampliar el apoyo de su base social y aumentar el control sobre la población a la que benefician, con el fin último de facilitar la continuación de su millonario negocio.
algodón	cotton	"""Pero cuando lo vimos de cerca notamos que no era algodón, sino bolsas de basura que están enredadas en las cercas de un inmenso territorio"", le dice a BBC Mundo."
hogares	homes	"El sociólogo Luis Pedro España concuerda en que en uno de cada cuatro hogares venezolanos ""concurren la angustia por la falta de alimentos con la disminución de los recursos para cubrir la cantidad y la calidad de la dieta""."
brasileña	Brazilian	Fue el primer paso para abordar el tema de la violencia de género en su aldea, al lado del río Tapajós, en la Amazonía brasileña.
le	you	"""Le enseñamos a ser como un perfumista..."
juicio	judgment	El juicio empezó en mayo de 1998.
investigadores	researchers	A pesar de esto, los investigadores en Idaho Falls no estaban preparados para darse por vencidos con este nuevo método.
guerra	war	Se calcula que la guerra contra el narcotráfico le ha costado a México alrededor de 250.000 vidas desde 2006, cuando el gobierno de entonces declaró una guerra abierta contra el narco.
competencias	competencies	 Pero quizás te sorprenda saber que tiene seguidores capaces de hazañas numéricas asombrosas y que incluso existen competencias para ver quién sabe más decimales de Pi de memoria.  
decimales	decimals	 Pero quizás te sorprenda saber que tiene seguidores capaces de hazañas numéricas asombrosas y que incluso existen competencias para ver quién sabe más decimales de Pi de memoria.  
millonarios	millionaires	"Varios de los firmantes pertenecen también al grupo de ""Millonarios Patrióticos"", unos 200 ultrarricos que ya antes de la pandemia pedían que les subieran los impuestos.  "
juegos	games	"""Esto se debe a que estos artículos ahora están firmemente arraigados en la nostalgia de los juegos infantiles para muchos coleccionistas de entre 30 y 40 años"", explicó."
si	yes	Mondolfi Gudat señala: “No comparto esa visión de la maldición del petróleo (…) porque creo que si algo hizo el petróleo fue darle un sentido absolutamente inesperado a lo que iba a significar la dinámica venezolana y al mejoramiento no sólo de las condiciones materiales de la sociedad, sino del advenimiento de agentes de poder distintos a los núcleos gobernantes”.
tratamiento	treatment	Los estudios indican que el sistema de tratamiento de aguas residuales puede eliminar la presencia del virus, pero la precaria situación sanitaria en países como Brasil puede conducir a la descarga de una gran carga viral en los ríos sin el tratamiento adecuado.
espacio	space	"Si las vamos a usar, lo más importante a tener en cuenta es ""cuán lejos el protector se curva para cubrir las orejas (si queda un espacio los aerosoles podrían entrar por esa vía y provocar una infección) y qué tanto se extiende por debajo (para protegernos de los aerosoles flotantes que podemos inhalar bajo el protector)"", le dice Tang a BBC Mundo.  "
imagen	image	Muchos antropólogos físicos y genetistas se disociaron de la imagen que los totalitarismos y el colonialismo querían dar sobre la variabilidad humana.
gotas	drops	"""Creemos que la ruta de transmisión primaria de la covid-19 es a través de las gotas, con lo cual hay dos formas de protegerse de ellas: una es cubriendo tu boca y tu nariz con una mascarilla, pero eso deja el resto de tu cara al descubierto"".  "
reino	kingdom	"Para Arun Advani, profesor de la Universidad de Warwick, Reino Unido, un impuesto al patrimonio, como el que proponen los ultrarricos es ""muy buena idea"".  "
condado	county	"""Hemos estado trabajando estrechamente con el gobernador Ron DeSantis y el equipo del Cirujano General de Florida para aumentar la localización de contactos en todo el condado de Miami-Dade."
comunidad	community	"""Nosotros tenemos un modelo de negocio orientado a la comunidad."
usar	use	La crisis fue tan profunda y tan rápida que muchos tuvieron que usar ataúdes de cartón para sus seres queridos.
mongol	Mongolian	A ello, se sumó otra medida sin precedentes y controvertida: la cancelación de las celebraciones por el Tsagaan Sar, el Año Nuevo lunar mongol.
asombrosas	amazing	 Pero quizás te sorprenda saber que tiene seguidores capaces de hazañas numéricas asombrosas y que incluso existen competencias para ver quién sabe más decimales de Pi de memoria.  
conscientes	conscious	Lo que dicen a veces parece indicar que no son conscientes en absoluto de los objetos que tienen frente a ellos.  
modificados	modified	Los ratones genéticamente modificados se usarán en los llamados estudios de desafío para verificar la efectividad: después de aplicar la vacuna, se intenta infectarlos con el virus.  
américa	America	Cada año, unas 100 millones de toneladas de partículas de polvo y otros elementos son llevadas por los vientos alisios hacia Europa y América.
economía	economy	“Equivocado” Buttó, quien es director del Centro Latinoamericano de Estudios de Seguridad, considera que el editorial tenía un problema: “El planteamiento de Uslar estaba equivocado de raíz porque consideraba que la economía basada en la explotación de los recursos petroleros, la cual estaba en pleno crecimiento, era negativa, destructora porque su fundamento era la renta”, explica.
subsahariana	sub-saharan	Además, la ONU proyecta que India superará a China como el país más poblado del mundo alrededor de 2027, mientras la población del África Subsahariana se duplicará para 2050.
cuántos	how many	El mapa que incluimos aquí —que se actualiza dos veces al día— te permitirá mantenerte informado de cuántos son los infectados y muertos por el virus y en qué países se encuentran.  
historia	history	Así lo cuenta Andrea Tone, profesora de Historia de la Universidad McGill, en la animación de TED Ed: “How one scientist averted a national health crisis” (“Cómo una científica evitó una crisis nacional de salud”).
buttó	butt	Buttó reflexiona: “Si estuviese de acuerdo con eso, negaría mi propia condición”.
edición	edition	Guion y presentación: Ana Pais Edición, animación y sonido: Tere Lari Ahora puedes recibir notificaciones de BBC Mundo.
años	years	En septiembre de 2015, el niño, que entonces tenía 6 años, comenzó las visitas a la casa de los padres adoptivos.
federales	federal	Otros pueden ser procesados en cortes federales según la gravedad de los mismos.
persas	Persians	Los planes de conquista del flamante Imperio de Palmira surgieron inicialmente como un presunto intento de defender al Imperio romano de sus enemigos persas.
arqueólogos	archaeologists	"Los arqueólogos descubrieron un esqueleto de ""alto estatus"" enterrado en un ataúd ""costoso"" de plomo."
móviles	mobiles	Muchos países se están preparando para pasar de redes móviles 4G a 5G, más avanzadas.  
gente	people	"""Al fin y al cabo, el que la gente de un país sea productiva no depende del recurso con el que cuenta sino de la consciencia sobre su papel en la construcción de la nación”."
exposición	exposition	Pero, con los aerosoles más pequeños, el protector fue menos efectivo, bloqueando al 68% inmediatamente después de la exposición a la tos, y solo al 23% en los 30 minutos siguientes, ya que estos aerosoles más pequeños pueden quedar flotando bajo el visor, en el espacio donde se produce la inhalación.  
latina	latin	La población de América Latina y el Caribe, que se triplicó en tamaño entre 1950 y 2019, alcanzará su punto máximo justo por debajo de 768 millones alrededor de 2058 y luego disminuirá a unos 680 millones en 2100, proyecta la ONU.
escena	scene	El laboratorio permaneció abierto hasta tarde en la noche y el personal trabajó durante el fin de semana para extraer el ADN y compararlo con el semen y el pelo dejado en la escena del crimen.
contagio	contagion	"Snow no aceptaba la teoría más extendida en ese momento, según la cual el contagio se debía al ""aire podrido y viciado""."
género	gender	"""Además, una de las cosas que me gusta de la serie es que muestra la metamorfosis de la violencia de género, que antes veíamos en otros ámbitos y ahora la vemos en las redes sociales todo el tiempo"", añade.  "
compañía	company	"""Los 'antiguos' juegos empaquetados (y sin uso) que están asociados a marcas y compañías de videojuegos muy valoradas, especialmente si son versiones raras, han aumentado enormemente su precio en los últimos 20 años"", describió Piers Harding-Rolls, experto en videojuegos de la compañía de investigación Amper Analysis."
unidos	United	"Estados Unidos argumenta que la Ley de Inteligencia Nacional de China de 2017, que dice que las organizaciones deben ""apoyar, cooperar y colaborar en el trabajo de inteligencia nacional"", significa que Pekín podría obligar a Huawei a hacer espionaje."
geriátricas	geriatric	Nada que ver con lo que ocurrió en marzo y abril, durante la primera ola del tsunami, cuando la covid-19 hizo estragos entre la población más vulnerable, sobre todo en ancianos y en las residencias geriátricas.
objetos	objects	Rick insistía en que no creía que realmente hubiera objetos frente a él.  
hijo	son	"Pude ver que su madre finalmente recuperó a su hijo"", dijo Dodge."
regresar	to return	"""Yo sé que mucha gente se pregunta por qué quiero regresar a Venezuela cuando todo el mundo se quiere ir"", añade la apurense.  "
habitantes	population	Según ese estudio, el virus también habría circulado entre los habitantes del país un mes antes de lo estimado por el gobierno federal.
residuales	residual	Según los investigadores, el virus se identificó en las muestras de aguas residuales utilizando la prueba RT-PCR, capaz de detectar la presencia de SARS-CoV-2 a partir de las 24 horas después de la contaminación del paciente.
monumentos	monuments	¿Existe una frontera clara entre lo que debe ser aceptado y removido como monumentos en nuestras sociedades de hoy?
de	of	De acuerdo con el alcalde Miami-Dade, Carlos Giménez, dado que la cifra de positivos supera el 20%, las autoridades dan por hecho que una de cada cuatro personas tiene coronavirus, presente síntomas o no.
unido	United	Su tratamiento ha sido aprobado en pacientes con covid-19 en Estados Unidos y Reino Unido, entre otros países.
contagios	infections	Pero, de incrementarse los contagios en Cajamarca, no se darían abasto.
juntos	together	Que la orquesta siga sonando, no sólo desde la distancia sino todos juntos en un mismo espacio y que podamos ser portavoces de buenas noticias.
prisión	prison	Casi dos años después del asesinato de Angie Dodge, Tapp fue enviado a prisión y el caso se estancó.
incluso	even	Incluso Cruzado señala que se invirtieron más de 14 millones de soles (US$3,9 millones) para la dotación de camas, ventilares y monitores que sirvieron para resolver los primeros casos.
cráneo	skull	Por ejemplo el color de la piel, el tamaño y la morfología del cráneo.
palabras	words	En otras palabras, hay muchas fronteras diferentes.
inteligencia	intelligence	Se dice que cautivaba por su inteligencia, además de su belleza.
fresno	ash tree	Como la experiencia de Fresno ha dado resultados, ahora Irma y su equipo han comenzado a expandirse con proyectos en otras ciudades.
cuadrados	squares	Hoy la firma es dueña de 46.000 metros cuadrados y está trabajando en un proyecto para rediseñar un edificio de 1918 que le permita arrendar espacios para oficinas, comercios y restaurantes.
pais	country	Investigación: Ana Pais- Guion: Inma Gil- Edición de video: Enric Botella- Presentadora: Ana María Roura -Editora: Natalia Pianzola.
sembrar	plant	Ese es uno de los fragmentos del editorial que el intelectual venezolano escribió ese año y que tituló: “Sembrar el petróleo”.
franquicia	franchise	Y a menudo se califica a la franquicia del videojuegos como la más exitosa hasta este momento.
hombres	mens	"""Pero eso es particularmente irónico porque las estadísticas oficiales muestran que en realidad el coronavirus impacta a los hombres más seriamente que a las mujeres"", agrega el científico."
medidas	measurements	"La Organización Mundial de la Salud, por ejemplo, apoya el uso de mascarillas como ""parte de una estrategia integral de medidas para suprimir la transmisión""."
protector	protective	Pero, con los aerosoles más pequeños, el protector fue menos efectivo, bloqueando al 68% inmediatamente después de la exposición a la tos, y solo al 23% en los 30 minutos siguientes, ya que estos aerosoles más pequeños pueden quedar flotando bajo el visor, en el espacio donde se produce la inhalación.  
madera	wood	El apartamento de Angie quedaba en la planta superior de un inmueble enchapado en madera desteñida, sobre una callada calle en el norte de la ciudad.
universidad	college	En la Universidad de Chicago, Kelsey no sólo trabajó como investigadora sino como profesora.  
selva	jungle	"""Tenemos que darles a las personas de la selva amazónica el lugar que les corresponde""."
transmisión	transmission	Sin embargo, esta vía de transmisión, le explica a BBC Mundo Luis Ostrosky, profesor de enfermedades infecciosas de la Escuela de Medicina McGovern de UTHealth de Houston, EE.UU., no es la principal.  
aerosoles	aerosol sprays	Pero, con los aerosoles más pequeños, el protector fue menos efectivo, bloqueando al 68% inmediatamente después de la exposición a la tos, y solo al 23% en los 30 minutos siguientes, ya que estos aerosoles más pequeños pueden quedar flotando bajo el visor, en el espacio donde se produce la inhalación.  
reina	Queen	Más allá de lo que pasó con ella, el legado más tangible que dejó la reina Zenobia fue el esplendor de su ciudad, que hoy sigue siendo considerada una de las joyas de la antigüedad.
rastreo	tracking	De acuerdo con Trepka, uno de los elementos que ha conllevado el aumento del número de casos es que las capacidades para el rastreo de contactos se han visto limitadas.
comunidades	communities	Representa a las cinco comunidades que viven en la Amazonía brasileña.
determinar	decide	Esta proposición presenta una dificultad, porque determinar si alguien es consciente de algo en particular es una tarea complicada y muy delicada.  
poblaciones	populations	"En una de esas entregas, el pasado junio, Akalapeizime Castro, jefe del ente público Mercal, encargado de luchar contra la inseguridad alimentaria, dijo que ""en está cuarentena colectiva, el gobierno nacional asegura la alimentación a las poblaciones más vulnerables""."
mongola	Mongolian	Las escenas de esta colorida competición rememoran el pasado imperial mongol y es a esta etapa de su historia a la que algunos vuelven para explicar la victoria mongola contra el coronavirus.
calles	streets	La provincia de Guayas fue una de las más afectadas y los fallecidos se agolpaban en las calles a la espera de ser enterrados.
caribe	Caribbean	La población de América Latina y el Caribe, que se triplicó en tamaño entre 1950 y 2019, alcanzará su punto máximo justo por debajo de 768 millones alrededor de 2058 y luego disminuirá a unos 680 millones en 2100, proyecta la ONU.
carta	letter	La Organización Mundial de la Salud (OMS) reconoció recientemente, en respuesta a una carta abierta publicada por más de 200 científicos, que hay cada vez más evidencia de que el coronavirus puede propagarse por estas pequeñas partículas suspendidas en el aire.
aplicación	application	En una entrevista con la Universidad de Victoria, de Canadá, Kelsey recordó esa etapa de su vida profesional: “Mi primera aplicación fue para el fármaco talidomida y me la dieron porque, como era nueva, pensaron que debía tener una (solicitud) fácil para empezar”, dijo.
estadounidense	U.S	“Muchos de los que se tomaron la medicina, incluyendo un número alto de niños, sufrieron de una muerte agonizante”, recordó el periódico estadounidense.
compartir	share	Agradecemos a @dieguisimo por este proyecto y por dejarnos compartir algunas de sus fotos.
negocio	deal	El negocio ganaría dinero cobrando a los padres una tarifa mensual por hijo, que actualmente es de US$3,8.
pantallas	screens	En opinión de Julian Tang, profesor del departamento de Ciencias Respiratorias de la Universidad de Leicester, en Reino Unido, las pantallas faciales son por lo general bastante efectivas, pero reconoce que compararlas directamente con las mascarillas quirúrgicas es difícil, y que los estudios que se han hecho hasta el momento solo lo han logrado de forma limitada.  
encontrar	find	"""Le dije a Carol que las cosas se veían bien e íbamos a poder encontrar al asesino"", expresó Moore."
ciclo	cycle	Sobre este y otros temas habló el nobel, quien en varias oportunidades hizo referencia a un video previo con sus tres reflexiones sobre la pandemia provocada por el nuevo coronavirus, la cual puede verse aquí: El ciclo #ImaginaElMundo contó con otros nueve pensadores de distintas partes del mundo quienes, desde el confinamiento, también dieron sus respectivas perspectivas sobre cómo será el mundo después de la covid-19 y que puedes ver aquí: Visita nuestra cobertura especial Recuerda que puedes recibir notificaciones de BBC Mundo.
pacientes	patients	El Hospital Simón Bolívar, al que hace referencia, es un centro materno-infantil que tuvo que ser acondicionado para atender a los pacientes con covid-19, porque ni siquiera contaba con una unidad de cuidados intensivos, explica Cruzado.  
aromas	scents	Usando una pantalla táctil, el perfumista puede reunir diferentes aromas utilizando datos de la amplia biblioteca de fórmulas de fragancias de la marca, un proceso mucho más eficiente que el uso de hojas de cálculo.  
rasgos	features	"Por ejemplo, los rasgos europeos eran considerados ""superiores, equilibrados, hermosos"", y eran el reflejo exterior de la ""inteligencia y la educación"" que caracterizaban a todo europeo."
me	I	Me la eché en dos días (intensos).
misterio	mystery	"""La muerte del hombre de Wellwick Farm sigue siendo un misterio para nosotros, pero no hay muchas maneras de terminar en el fondo de una zanja, boca abajo, con las manos atadas"", señaló Woods."
cerebro	brain	"""Aquí hay un lavado de cerebro y una manipulación a gran escala"", declaró Heavey."
campesinas	peasant	"""Surgimos debido a la necesidad de preservar y proteger los bienes colectivos, que estaban amenazados por el abigeato (hurto de ganado)"", explicó Aladino Fernández, presidente de la federación regional de rondas campesinas de Cajamarca.  "
libertad	freedom	"¡Libertad!"", dijo en voz alta Thomas, mientras le alzaba la mano en alto."
hombre	man	"""Todavía pienso que mi esposo cree que un hombre sano como él no se enfermará"", dice Mónica."
ejecución	execution	Según los periodistas presentes en la ejecución, Lee mantuvo su inocencia hasta el final.
proyecta	projects	La población de América Latina y el Caribe, que se triplicó en tamaño entre 1950 y 2019, alcanzará su punto máximo justo por debajo de 768 millones alrededor de 2058 y luego disminuirá a unos 680 millones en 2100, proyecta la ONU.
ferroviaria	railway	Todos estos forman parte de una serie de hallazgos que van desde la era neolítica hasta el período medieval, que han sido desenterrados antes de los trabajos de construcción de una línea ferroviaria de alta velocidad.
podría	could	Pero según el instrumento -con el que la UCAB viene midiendo la realidad económica y social de Venezuela desde 2014-, menos de uno de cada 10 hogares del país (7%) está completamente libre de inseguridad alimentaria, una cifra que podría reducirse al 3% como resultado de la pandemia.
familia	family	"""Algo que siempre me había molestado fue un matrimonio muy joven en la familia"", indicó."
perfume	fragrance	El cofundador de ScenTronix, Frederik Duerinck, dice que quería que las personas pudieran usar un perfume que fuera un reflejo de sí mismos.
humanos	humans	Los seres humanos siguen siendo seres humanos.
ministerio	ministry	"La revocación de la adopción fue aprobada por un juez, con el acuerdo del Ministerio Público"", justificó Salotto."
mascarilla	mask	"""Recomendamos su uso en el caso de un trabajador sanitario, por ejemplo, que debe entrar en la habitación de un paciente que tiene o se sospecha que tiene covid-19 y no lleva mascarilla"", le dice a BBC Mundo.  "
sonido	sound	Guion y presentación: Ana Pais Edición, animación y sonido: Tere Lari Ahora puedes recibir notificaciones de BBC Mundo.
muestras	samples	 Investigadores de al menos cuatro países, incluyendo Brasil, detectaron la presencia del nuevo coronavirus en muestras de aguas residuales recolectadas semanas o meses antes del primer caso registrado oficialmente en la ciudad china de Wuhan, considerado como el origen de la actual pandemia.
seal	signal	"""Hay entre 10 y 12 millones de millonarios en este país y solo somos 200, ¿qué diferencia podemos hacer?"", dijo Seal Stewart en una entrevista a principios de este año."
ciudades	cities	"""Hemos encontrado una manera distinta de reconstruir las ciudades estadounidenses utilizando tecnología"", dice la fundadora de Bitwise."
organiza	organizes	"Un equipo de la BBC obtuvo acceso exclusivo a las bodegas desde las cuales organiza sus donaciones el cartel de Sinaloa, la organización liderada por Joaquín ""El Chapo"" Guzmán, preso en Estados Unidos desde enero de 2016.  "
imperio	empire	Con gran astucia militar, logró no solo mantener a raya a los persas sino también conquistar terrenos que pertenecían al Imperio romano.
monto	amount	Pero si el monto es grande y la devolución puede tomar más de un año, entonces ese tema podría también formar parte del acuerdo.
dieguisimo	twentieth	Diego Vallenilla se describe como “un venezolano viviendo en Venezuela” y ha estado publicando en su cuenta de Instagram (@dieguisimo) algunos deseos de la gente en medio de esta cuarentena.
casos	cases	Para comprender cabalmente estos casos, necesitaremos emplear una cuidadosa reflexión filosófica sobre los conceptos que usamos y los supuestos que hacemos, así como hacer una investigación científica exhaustiva de la mecánica de la mente.
derribar	shoot down	"""Puedes derribar todos los monumentos del mundo, pero eso no cambia necesariamente lo que ocurrió."
renta	rent	“Equivocado” Buttó, quien es director del Centro Latinoamericano de Estudios de Seguridad, considera que el editorial tenía un problema: “El planteamiento de Uslar estaba equivocado de raíz porque consideraba que la economía basada en la explotación de los recursos petroleros, la cual estaba en pleno crecimiento, era negativa, destructora porque su fundamento era la renta”, explica.
firmantes	signers	También el guionista y director británico Richard Curtis y el cofundador de la marca de helados Ben&Jerry, Jerry Greenfield aparecen en la lista de los firmantes.  
lee	read	"""He cometido muchos errores en mi vida, pero no soy un asesino"", dijo Lee en su declaración final."
manada	herd	"Según los testimonios durante el juicio, los cinco hombres grabaron un video de la violación y lo compartieron en el grupo de WhatsApp llamado ""La manada"" -de allí el nombre del caso-.  "
ratones	mice	"La demanda se concentra en una sola institución porque el laboratorio es posiblemente el único que produce estos ratones genéticamente modificados a escala ""comercial"", dice el coordinador del Instituto Nacional de Ciencia y Tecnología de Vacunas de Brasil (INCTV) y del equipo de Fiocruz Minas, Ricardo Gazzinelli."
terminé	I finished	Listo, terminé de ver #LaJauría.
repetía	repeated	"""Andamos y andamos por kilómetros y la misma imagen se repetía y se repetía""."
natalidad	birth	Fuente: Population Reference Bureau (PRB) Es sabido que la población está envejeciendo debido a un aumento de la esperanza de vida y niveles más bajos de natalidad.  
máquina	machine	"Ellos son los que tienen intuición, emoción y sentimiento y guían la máquina a mejores resultados""."
antropología	anthropology	También se evaluaron pruebas genéticas y moleculares en el ámbito de la antropología molecular.
niño	boy	"Sin embargo, citó que ""no se puede admitir que los adoptantes se comporten de manera intrascendente en su decisión de adoptar y recibir al menor en su familia dentro de la calidad de un niño"".  "
tarjeta	card	Su idea era crear una tarjeta de débito prepago y una aplicación para niños de 6 a 18 años que ayudaría a los niños a aprender cómo manejar sus propias finanzas.
tecnológico	technological	"""Quería traer las oportunidades del sector tecnológico a mi lugar de origen"", dice Olguin."
tierra	Earth	Pero alguna vez te preguntaste cuántos seres humanos han vivido en la Tierra hasta hoy.
perfumista	perfumer	"""Se trata de encontrar una manera de darle más tiempo al perfumista"", dice Calice Becker, directora de la Escuela de Perfumería de Givaudan."
aeropuerto	airport	"El periodista venezolano del proyecto Venezuela Migrante, Alessandro Di Stasio, visitó al grupo en el aeropuerto y califica la situación de sus connacionales como ""crítica"".  "
ultrarricos	ultra-rich	"Varios de los firmantes pertenecen también al grupo de ""Millonarios Patrióticos"", unos 200 ultrarricos que ya antes de la pandemia pedían que les subieran los impuestos.  "
padres	parents	Con respecto a la demanda, el abogado argumentó que los padres adoptivos no tuvieron tiempo para defenderse adecuadamente.  
fragancias	fragrances	La casa de fragancias alemana Symrise fue un paso más allá y se asoció con IBM Research para crear una IA de nombre Philyra, llamada así por la diosa griega del perfume, que en realidad estudia las fórmulas aromáticas y los datos de los clientes para producir nuevas fragancias.
tropicales	tropical	Los minerales contenidos en el polvo también reponen los nutrientes en los suelos de las zonas tropicales, que se ven afectados por las tradicionales lluvias de la región.
indígena	indigenous	Ednei es un joven líder indígena arapiun que recientemente se unió a la guardia de la Tierra Indígena Maró, en la Amazonía brasileña.
arrodillado	down on my knees	El esclavo arrodillado al lado del Lincoln casi divino, visualmente, sin ningún contexto, es una imagen racista.
operaciones	operations	"Fue nombrado por Hill en 2015, cuando ella cambió a la función de directora de operaciones, para poder concentrarse en las ""operaciones del día a día""."
escribió	wrote	"Por ejemplo, la usuaria Mariana G. Noriega escribió: ""Listo, terminé de ver #LaJauría."
petróleo	Petroleum	Buttó lo interpreta como una preocupación basada en la dinámica del negocio petrolero de esa época: “Yo creo que Uslar Pietri se refería a que la industria petrolera venezolana estaba en manos de compañías extranjeras y la única fuente de ingreso que Venezuela obtenía del negocio petrolero estaba basado en el cobro de regalías (…) Y los impuestos sobre la renta que generaba la venta de ese petróleo”.
respiratoria	respiratory	 Conocido como covid-19, se trata de una infección respiratoria que comienza con fiebre y tos seca y que, al cabo de cerca de una semana, puede provocar falta de aire.  
alimentos	foods	 Con su negativa ayudó a “salvar, quizás, a miles de personas de la muerte o de una incapacidad de por vida”, dice la Administración de Alimentos y Medicamentos (FDA, por sus siglas en inglés).
ulán	Ulan	"Los mensajes del gobierno desde Ulán Bator fueron rápidamente trasladados a los nómadas en las provincias más remotas"", remarcaba a ese medio el doctor Chinburen Jigjidsuren, asesor especializado en asuntos de Salud del primer ministro."
hospitalizaciones	hospitalizations	Datos de la Agencia para la Administración de Atención Médica (AHCA) de Florida revelan que el número de hospitalizaciones por covid-19 ha aumentado casi en un 68% en las últimas dos semanas, mientras el uso de respiradores se ha disparado en 109%.
natalia	Natalie	Investigación: Ana Pais- Guion: Inma Gil- Edición de video: Enric Botella- Presentadora: Ana María Roura -Editora: Natalia Pianzola.
corte	cut	Tenía un gran corte que le atravesaba la garganta y más de una decena de heridas punzantes en el cuerpo.
pagar	pay	Duerinck está de acuerdo en que hay que superar una barrera fisiológica importante, ya que las personas no están acostumbradas a pagar por una fragancia que no pueden probar hasta que se produce.
testificó	testified	En una audiencia que suscitó gran interés mediático, Maxwell testificó ante la juez Alison Nathan desde el Centro de Detención Metropolitano de Brooklyn en el que está detenida.
hambre	hungry	"""Estamos pasando hambre"", dijeron varios de los habitantes de la comuna El Bosque, uno de los municipios con menos recursos de la capital chilena."
venezolanas	Venezuelan	"Hemos recurrido a todas las autoridades venezolanas habidas y por haber"", reitera del Gaudio, vocero del grupo.  "
procesados	processed	Actualmente, hay 62 presos en el corredor de la muerte por casos procesados a nivel federal.
inseguridad	unsafety	La cifra también equivale al 33% de los hogares en situación de inseguridad alimentaria severa identificados en la última actualización de la ENCOVI, un aumento del 10% en comparación con los resultados del 2018.   
menos	less	“Kelsey se dio cuenta de que estar sometido a cierta presión por parte de un patrocinador de medicamentos entraba en el territorio de ser un revisor de fármacos de la FDA, al menos en esa época”, le indica a BBC Mundo la FDA.
madre	mother	"Me llamaban la madre loca en duelo"", agregó."
cómo	how	¿Cómo funciona entonces la visión ciega?
horizonte	horizon	En Belo Horizonte, por ejemplo, un proyecto piloto de la Agencia Nacional del Agua (ANA) analiza muestras de aguas residuales y señala que la cantidad de personas infectadas puede ser 20 veces mayor que la de los casos confirmados oficialmente.
habló	I speak	Sobre este y otros temas habló el nobel, quien en varias oportunidades hizo referencia a un video previo con sus tres reflexiones sobre la pandemia provocada por el nuevo coronavirus, la cual puede verse aquí: El ciclo #ImaginaElMundo contó con otros nueve pensadores de distintas partes del mundo quienes, desde el confinamiento, también dieron sus respectivas perspectivas sobre cómo será el mundo después de la covid-19 y que puedes ver aquí: Visita nuestra cobertura especial Recuerda que puedes recibir notificaciones de BBC Mundo.
perú	Peru	"La tasa es bastante baja con respecto a otros departamentos"", dice Augusto Tarazona, presidente del Comité de Salud Pública del Colegio de Médicos del Perú.  "
ganó	won	Ganó varios premios literarios, entre ellos, el Príncipe de Asturias de Las Letras y el Rómulo Gallegos.
colombia	Colombia	Fanny, cuyo viaje de regreso, vía Colombia, estaba programado para el 20 de marzo, intentó adelantar su vuelo cuando escuchó que varios países estaban suspendiendo viajes y cerrando fronteras.  
fotógrafo	photographer	"Esteban Vega, fotógrafo colombiano que trabaja para la revista Semana, estaba realizando un reportaje en la zona sobre migración cuando creyó encontrarse con ""un campo del algodón""."
lima	lime	Primero, su baja densidad de población en relación con la capital, Lima, que concentra tres cuartas parte de los habitantes del país.  
amigo	friend	Pese a todas las precauciones que puedas tomar cuando te piden dinero prestado, no deja de ser un terreno pantanoso que tiene un doble riesgo: perder tus fondos y perder un amigo.
fármacos	drugs	En la Universidad de Chicago, Kelsey evidenciaría “los peligros de la negligencia en la supervisión de fármacos”, cuenta Stephen Phillips, en “How a courageous physician-scientist saved the U.S. from a birth-defects catastrophe” (“Cómo una médica-científica salvó a EE.UU. de una catástrofe de defectos de nacimiento”), publicado en la web de esa universidad.
barajas	decks	Luciano puntualiza que algunas personas dentro de ese grupo se encuentran en situación de calle y no pueden ni siquiera costearse un pasaje para el aeropuerto de Barajas.
laboratorio	laboratory	Un laboratorio de la Universidad de Queensland, Australia, por ejemplo, realizó recolecciones en plantas de tratamiento de aguas residuales en todo el país para analizar los hábitos alimenticios y de consumo de drogas en diferentes comunidades.
trabajar	to work	En el área educativa la compañía imparte cursos de programación, además de clases en marketing digital, emprendimiento, y habilidades computacionales para trabajar en la nube.
aborda	tackles	"""Coronavir es una de las primeras drogas en Rusia y en el mundo que no aborda las complicaciones causadas por SARS-CoV-2, sino que combate el virus en sí mismo"", dijo su fabricante, R-Pharm.  "
piquetes	pickets	Los piquetes se reforzaron, de día y de noche.
neurológico	neurological	Se descubrió que el virus había afectado temporalmente su sistema neurológico.  
tren	train	"A post shared by  Banksy (@banksy) on Jul 14, 2020 at 6:30am PDT Al final del video, las palabras ""I get lockdown"" (algo así como ""me confino"" en español) aparecen en el muro de una estación antes de que se cierren las puertas del tren para revelar las palabras ""but I get up again"" (pero me vuelvo a levantar)."
nombre	Name	Llamaron el nombre de Angie pero no recibieron contestación.  
horas	hours	Había más de 25 horas de grabación, todo en cintas de VHS, con una pésima calidad de sonido y sin subtítulos.
podía	could	La policía le dijo que enfrentaba la pena de muerte pero que podía recibir una sentencia menos severa si confesaba que había temido por su vida durante el ataque.
inversión	investment	Pero el proyecto no solo beneficia a China: Pakistán necesita desesperadamente esta inversión.  
hacer	do	Te viste forzado a hacer algo que no querías hacer.
acceso	access	"""China siempre ha tenido un enfoque geoestratégico en sus fronteras occidentales, importantes para tener acceso a Europa, otros países de Asia Central o Irán."
los	the	"""Los celulares dominaban el mundo y ya no había contacto físico entre la gente."
bien	well	"""Quiero probarles a todos que puedo ser alguien y hacer algo bien"", declaró."
en	in	En una ocasión, un detective le sugiere que pudo haber borrado los recuerdos debido al trauma.
fronteras	borders	China siempre ha mirado hacia sus fronteras occidentales por razones comerciales u otros motivos estratégicos”, explica Saqlain Imam, periodista del servicio urdu de la BBC.  
varios	various	Tuvieron lugar en mayo de 1998 en el distrito de Chagai (por eso se llamaron Chagai-I), bajo el liderazo del primer ministro Nawaz Sharif, y resultaron en la condena internacional y en sanciones contra Pakistán en India por parte de varios estados.
irán	Iran	"""China siempre ha tenido un enfoque geoestratégico en sus fronteras occidentales, importantes para tener acceso a Europa, otros países de Asia Central o Irán."
momento	moment	Pero para Tapp, que vagaba en el momento sin trabajo, el asesinato simplemente fue otro tema de conversación durante un verano sin rumbo.
solo	alone	"""Pakistán tiene solo un gran puerto, el puerto de Karachi, que fue construido durante el período colonial hace más de 100 años"", agrega."
ataque	attack	Precisamente este último se adjudicó el ataque mortífero más reciente; a finales de junio cuatro hombres irrumpieron en la Bolsa de Valores de Karachi, la más importante de Pakistán, armados con fusiles y granadas, mataron a dos guardias de seguridad y a un policía e hirieron a otras siete personas antes de ser ultimados.
oponen	oppose	Diferentes comunidades se oponen a ellas, unas porque se sienten excluidas y otras por razones más ideológicas.  
quería	wanted to	"Lo único que quería era alejarme de ellos"", dijo Tapp años después."
separatistas	separatists	Los expertos y activistas estiman en que las tensiones entre Islamabad y los diferentes grupos separatistas baluchis continuarán hasta que ambos bandos lleguen a un acuerdo.  
dije	said	Dije: 'Angie,  perdóname.
persona	person	Los primeros esfuerzos de Dodge por encontrar a la otra persona involucrada en el asesinato de Angie no llegaron a nada.
agregó	added	"""Pero yo observaba a Chris y su comportamiento, y miraba a su abogado, y sentía como que las cosas no estaban -no puedo explicarlo- no se sentían normales"", agregó."
pruebas	tests	Pero las pruebas de ADN resultaron negativas y la policía se encontró otra vez en el principio.
evidencia	evidence	El método implica comparar la evidencia de ADN que se encuentra en la escena del crimen con el ADN de personas que entregan ADN a sitios web comerciales de genealogía como Ancestry.com.
sospechoso	suspect	"""El jefe Johnson dijo que el nuevo sospechoso era Brian Leigh Dripps Sr. y prácticamente me levanté de la silla"", dijo Carol.  "
ver	see	Angie Dodge no había llegado a cumplir su turno en el trabajo y, después de que no contestara sus llamadas, se apresuraron a ver si estaba bien.
armados	armed	Precisamente este último se adjudicó el ataque mortífero más reciente; a finales de junio cuatro hombres irrumpieron en la Bolsa de Valores de Karachi, la más importante de Pakistán, armados con fusiles y granadas, mataron a dos guardias de seguridad y a un policía e hirieron a otras siete personas antes de ser ultimados.
haber	to have	Estoy molesta por lo que me hicieron, cuando podrían haber resuelto este caso hace 23 años.
finalmente	Finally	"""Le dije: 'Voy a lograr esto, Carol, finalmente voy a encontrar  a este tipo y tu finalmente vas a tener justicia y respuestas""."
necesita	needs to	"""Pakistán tiene problemas económicos, necesita dinero y le está vendiendo nuestro territorio a China para intentar solventarlos"", le dice Kosa, quien es oriundo de Baluchistán y ahora vive en Londres, a BBC Mundo.  "
hace	does	"Algunos se oponen a todo lo que hace Pakistán, porque simplemente quieren convertirse en un país independiente"", detalla el periodista del servicio urdu de la BBC.  "
inocencia	innocence	Mientras tanto, Carol Dodge se secó las lágrimas de los ojos cuando el hombre que una vez creyó que había matado a su hija celebró su inocencia.
internacional	international	Pakistán es un país cuya deuda pública es superior al 80% de su PIB y su riqueza por el número de habitantes es de apenas unos US$1.500, según el Fondo Monetario Internacional (FMI).
tan	so	Tan pronto se alejó conduciendo, un detective encubierto corrió a recogerlo.  
contó	counted	Le contó a los investigadores lo que pensó que querían oír.
pib	gp	Con una inversión que ya se estima en alrededor de US$62 mil millones, una cifra superior al Producto Interno Bruto (PIB) de Nicaragua, el objetivo es construir una red de carreteras, ferrocarriles y gasoductos entre los dos países aliados.  
organización	organization	La BLA -organización detrás del ataque contra la Bolsa de Valores de Karachi el 29 de junio- es solamente uno de los seis grupos separatistas armados de Baluchistán y que previamente han ejecutado ataques en Pakistán.
parte	part	Situado en el mar Arábigo, el muelle está siendo desarrollado por China como parte del Corredor Económico China-Pakistán (CPEC, por sus siglas en inglés), un megaproyecto anunciado en abril de 2015.
locales	local	Las autoridades locales han negado las acusaciones en diversas ocasiones.  
bla	blah	La BLA -organización detrás del ataque contra la Bolsa de Valores de Karachi el 29 de junio- es solamente uno de los seis grupos separatistas armados de Baluchistán y que previamente han ejecutado ataques en Pakistán.
proyecto	draft	Pero el proyecto no solo beneficia a China: Pakistán necesita desesperadamente esta inversión.  
ejército	army	Baluchistán actualmente es una provincia de difícil acceso para periodistas y grupos de derechos humanos, sin embargo, a lo largo de los años se han documentado diversos abusos y denuncias de represión a gran escala por parte del Ejército paquistaní.  
bolsa	bag	Precisamente este último se adjudicó el ataque mortífero más reciente; a finales de junio cuatro hombres irrumpieron en la Bolsa de Valores de Karachi, la más importante de Pakistán, armados con fusiles y granadas, mataron a dos guardias de seguridad y a un policía e hirieron a otras siete personas antes de ser ultimados.
quién	who	"""Yo iba directamente allí donde estaban los detectives, con sus pies sobre los escritorios, y les preguntaba con quién habían hablado y cuándo iban a resolver el asesinato"", explicó Dodge."
sienten	feel	"""Otros grupos sienten que el gobierno federal que está dominado por Punjab -la provincia más poblada del país y la segunda más grande por superficie después de Baluchistán- no les permite a los baluchis tener una voz en los proyectos"".   "
razones	reasons	Diferentes comunidades se oponen a ellas, unas porque se sienten excluidas y otras por razones más ideológicas.  
afganistán	Afghanistan	Pero más allá de aquello, Baluchistán comparte una extensa y porosa frontera con Afganistán e Irán y es hogar de una insurgencia de larga data, emprendida por los nacionalistas baluchis contra el gobierno pakistaní, un conflicto que ha dejado miles de víctimas mortales de ambos bandos.
querían	they wanted	Querían saber si Tapp tenía información que pudiera implicar a su amigo, aunque Tapp continuó negando conocimiento alguno del crimen.
vida	lifetime	Le dijeron que tenía que admitir eso si quería salvar su vida.
vez	time	"""Traté de salvarme y lo que hice fue excavar cada vez más el hueco"", dijo."
siglas	acronym	Situado en el mar Arábigo, el muelle está siendo desarrollado por China como parte del Corredor Económico China-Pakistán (CPEC, por sus siglas en inglés), un megaproyecto anunciado en abril de 2015.
territorio	territory	"""Pakistán tiene problemas económicos, necesita dinero y le está vendiendo nuestro territorio a China para intentar solventarlos"", le dice Kosa, quien es oriundo de Baluchistán y ahora vive en Londres, a BBC Mundo.  "
estoy	am	"Estoy muy agradecida que lo pudimos compartir"", agregó."
occidentales	western	China siempre ha mirado hacia sus fronteras occidentales por razones comerciales u otros motivos estratégicos”, explica Saqlain Imam, periodista del servicio urdu de la BBC.  
interrogatorio	interrogation	Harvey tomó nota de momentos cruciales en el interrogatorio de la policía y concluyó que Tapp había sido engañado -que hasta le habían lavado el  cerebro- para que diera un testimonio falso.  
mar	sea	Pakistán, a diferencia de Japón, Corea del Sur y Taiwán -países que se encuentran del lado oriental de las fronteras marítimas de la segunda economía del mundo- es un aliado histórico de China y si el gigante asiático quiere una salida al mar alternativa, Baluchistán es una de sus pocas apuestas.
luego	then	Sus abogados afirmaría luego que estuvo más de 100 horas bajo interrogación intensa de la policía.
prueba	test	Con la ayuda  de Hampikian, Dodge forzó al Departamento de Policía de Idaho Falls de intentar con algo llamado prueba de ADN familiar.  
allí	there	"""Sin encontrar al asesino de mi hija y la persona con el ADN correspondiente"", destacó, ""¿podríamos probar que Chris no estuvo allí?""."
muestra	shows	El departamento se dedicó a encontrar quién había dejado la muestra de ADN.
objetivo	objective	Con una inversión que ya se estima en alrededor de US$62 mil millones, una cifra superior al Producto Interno Bruto (PIB) de Nicaragua, el objetivo es construir una red de carreteras, ferrocarriles y gasoductos entre los dos países aliados.  
policías	police	"""Noté que los policías también le proveyeron detalles del crimen a Chris y le hicieron preguntas capciosas"", indicó la profesora Redlich.  "
dio	it gave	La policía investigó el nombre que Moore les dio y quedaron sorprendidos con lo que encontraron.
ejecutado	executed	Pakistán ha ejecutado proyectos gasíferos para explotar el gas de Baluchistán, por ejemplo.
te	tea	"Vistiendo camisetas estampadas que decían ""¡Te lo dijimos!"" e ""Inocente"", los amigos y simpatizantes de Tapp vitorearon en la sala del tribunal cuando se dio a conocer la noticia."
inocente	innocent	Tomando un paso increíble, Dodge dijo públicamente que creía que Tapp -que ya llevaba casi dos décadas en la cárcel por el asesinato de su hija- era inocente.
recuerda	remember	"Durante los últimos 40 años, las inversiones en infraestructura en Pakistán han sido escasas"", recuerda Imam.  "
río	River	Eran conocidos en Idaho Falls y se la pasaban veranos enteros bromeando y bebiendo en la orilla del río.
recordó	remembered	"Moore sostuvo una conferencia de video con los detective en Idaho Falls y explicó que tenía un nuevo nombre: Brian Leigh Dripps Sr.  ""Quedé muda de la emoción por un minuto y empecé a llorar"", recordó."
inversiones	investments	Pero el conjunto de inversiones causa tensiones.
militantes	militants	Los militantes se oponen ferozmente a la inversión china, pues argumentan que no trae ningún beneficio para la población local.
mientras	While	Mientras tanto, Carol Dodge estaba confundida.
punjab	Punjab	"""Otros grupos sienten que el gobierno federal que está dominado por Punjab -la provincia más poblada del país y la segunda más grande por superficie después de Baluchistán- no les permite a los baluchis tener una voz en los proyectos"".   "
valores	values	La BLA -organización detrás del ataque contra la Bolsa de Valores de Karachi el 29 de junio- es solamente uno de los seis grupos separatistas armados de Baluchistán y que previamente han ejecutado ataques en Pakistán.
periodista	journalist	"Algunos se oponen a todo lo que hace Pakistán, porque simplemente quieren convertirse en un país independiente"", detalla el periodista del servicio urdu de la BBC.  "
pakistaní	Pakistani	Pero más allá de aquello, Baluchistán comparte una extensa y porosa frontera con Afganistán e Irán y es hogar de una insurgencia de larga data, emprendida por los nacionalistas baluchis contra el gobierno pakistaní, un conflicto que ha dejado miles de víctimas mortales de ambos bandos.
había	had	Había más de 25 horas de grabación, todo en cintas de VHS, con una pésima calidad de sonido y sin subtítulos.
así	So	"Así que tomamos el caso"", contó."
su	its	Su juicio está programado para  junio de 2021 y se ha declarado no culpable.
servicio	service	China siempre ha mirado hacia sus fronteras occidentales por razones comerciales u otros motivos estratégicos”, explica Saqlain Imam, periodista del servicio urdu de la BBC.  
económico	economic	Situado en el mar Arábigo, el muelle está siendo desarrollado por China como parte del Corredor Económico China-Pakistán (CPEC, por sus siglas en inglés), un megaproyecto anunciado en abril de 2015.
